NO ./aer.xpm
SO ./aer.xpm
WE ./aer.xpm
EA ./aer.xpm

F 220,100,0
C 225,30,0

1111111111111111111111111111111
10101010101010101001
1111111111111111111111111111111
1N100001                    101
1111111111111111111111111111111
1111111111111111111111111111111
1000000000000000000000000000001
1000000000000000000000000000001
1000000000000000000111111111111
111111101111101111011      1  1
111111101111101111011      1  1
111111101111101111011      1  1
111111101111101111011      1  1
11    111 11111111111
