NO ./aer.xpm
SO ./aer.xpm
WE ./aer.xpm
EA ./aer.xpm

F 220,100,0
C 225,30,0

1111111111111111111111111
1000000001100000000000011
1111111110000011100000001
1001000000000000000000001
111111111011000001110000111111111111
100000000011000001110111111111111
111101111111110111000000100011
1111011111111101 101010010001
11000000110101011100000010001
10000000000000001100000010001
10000000000000000101010011101
110000011101010101010110N0111
111101111110101100011010001
111111111111111111111111111
